5 5 1 2
0 0 0 0 1
0 0 0 1 1
0 0 1 1 0
0 1 1 0 0
1 1 0 0 0
4 0
5 4
0 4 3